R  700 500
NO textures/colorstone.xpm
SO textures/greystone.xpm
WE textures/purplestone.xpm
EA textures/wood.xpm
S  textures/barrel.xpm
F 117,91,41
C 50,157,168

1111111111111111111111111
1000000000110000000000001
1011000001110000002000W01
1001000000000000000000001
1111111110110000011100001
1111111111111111111111111