R  1080 900
S  textures/barrel.xpm
NO textures/colorstone.xpm
SO textures/greystone.xpm
WE textures/purplestone.xpm
EA textures/wood.xpm
F 10,91,41
C 3,211,252

1111111
1000S01
1002001
1002001
1002001
1002001
1002001
1002001
1002001
1002001
1002001
1002001
1002001
1002001
1002001
1002001
1002001
1002001
1002001
1002001
1002001
1002001
1002001
1002001
1002001
1002001
1002001
1002001
1002001
1002001
1002001
1002001
1002001
1002001
1002001
1002001
1002001
1002001
1002001
1002001
1002001
1002001
1002001
1002001
1002001
1002001
1002001
1002001
1002001
1002001
1002001
1002001
1002001
1002001
1002001
1002001
1002001
1002001
1002001
1002001
1002001
1002001
1002001
1002001
1002001
1002001
1002001
1002001
1002001
1002001
1002001
1002001
1002001
1002001
1002001
1002001
1002001
1002001
1002001
1002001
1002001
1002001
1002001
1002001
1002001
1002001
1002001
1002001
1002001
1002001
1002001
1002001
1002001
1002001
1002001
1002001
1002001
1002001
1002001
1002001
1002001
1002001
1002001
1002001
1002001
1002001
1002001
1002001
1002001
1002001
1002001
1002001
1002001
1002001
1002001
1002001
1002001
1002001
1002001
1002001
1002001
1002001
1002001
1002001
1002001
1002001
1002001
1002001
1002001
1002001
1002001
1002001
1002001
1002001
1002001
1002001
1002001
1002001
1002001
1002001
1002001
1002001
1002001
1002001
1002001
1002001
1002001
1002001
1002001
1002001
1002001
1002001
1002001
1002001
1002001
1002001
1002001
1002001
1002001
1002001
1002001
1002001
1002001
1002001
1002001
1002001
1002001
1002001
1002001
1002001
1002001
1002001
1002001
1002001
1002001
1002001
1002001
1002001
1002001
1002001
1002001
1002001
1002001
1002001
1002001
1002001
1002001
1002001
1002001
1002001
1002001
1002001
1002001
1002001
1002001
1002001
1002001
1002001
1002001
1002001
1002001
1002001
1002001
1002001
1002001
1002001
1002001
1002001
1002001
1002001
1002001
1002001
1002001
1002001
1002001
1002001
1002001
1002001
1002001
1002001
1002001
1002001
1002001
1002001
1002001
1002001
1002001
1002001
1002001
1002001
1002001
1002001
1002001
1002001
1002001
1002001
1002001
1002001
1002001
1002001
1002001
1002001
1002001
1002001
1002001
1002001
1002001
1002001
1002001
1002001
1002001
1002001
1002001
1002001
1002001
1002001
1002001
1002001
1002001
1002001
1002001
1002001
1002001
1002001
1002001
1002001
1002001
1002001
1002001
1002001
1002001
1002001
1002001
1002001
1002001
1002001
1002001
1002001
1002001
1002001
1002001
1002001
1002001
1002001
1002001
1002001
1002001
1002001
1002001
1002001
1002001
1002001
1002001
1002001
1002001
1002001
1002001
1002001
1002001
1002001
1002001
1002001
1002001
1002001
1002001
1002001
1002001
1002001
1002001
1002001
1002001
1002001
1002001
1002001
1002001
1002001
1002001
1002001
1002001
1002001
1002001
1002001
1002001
1002001
1002001
1002001
1002001
1002001
1002001
1002001
1002001
1002001
1002001
1002001
1002001
1002001
1002001
1002001
1002001
1002001
1002001
1002001
1002001
1002001
1002001
1002001
1002001
1002001
1002001
1002001
1002001
1002001
1002001
1002001
1002001
1002001
1002001
1002001
1002001
1002001
1002001
1002001
1002001
1002001
1002001
1002001
1002001
1002001
1002001
1002001
1002001
1002001
1002001
1002001
1002001
1002001
1002001
1002001
1002001
1002001
1002001
1002001
1002001
1002001
1002001
1002001
1002001
1002001
1002001
1002001
1002001
1002001
1002001
1002001
1002001
1002001
1002001
1002001
1002001
1002001
1002001
1002001
1002001
1002001
1002001
1002001
1002001
1002001
1002001
1002001
1002001
1002001
1002001
1002001
1002001
1002001
1002001
1002001
1002001
1002001
1002001
1002001
1002001
1002001
1002001
1002001
1002001
1002001
1002001
1002001
1002001
1002001
1002001
1002001
1002001
1002001
1002001
1002001
1002001
1002001
1002001
1002001
1002001
1002001
1002001
1002001
1002001
1002001
1002001
1002001
1002001
1002001
1002001
1002001
1002001
1002001
1002001
1002001
1002001
1002001
1002001
1002001
1002001
1002001
1002001
1002001
1002001
1002001
1002001
1002001
1002001
1002001
1002001
1002001
1002001
1002001
1002001
1002001
1002001
1002001
1002001
1002001
1002001
1002001
1002001
1002001
1002001
1002001
1002001
1002001
1002001
1002001
1002001
1002001
1002001
1002001
1002001
1002001
1002001
1002001
1002001
1002001
1002001
1002001
1002001
1002001
1002001
1002001
1002001
1002001
1002001
1002001
1002001
1002001
1002001
1002001
1002001
1002001
1002001
1002001
1002001
1002001
1002001
1002001
1002001
1002001
1002001
1002001
1002001
1002001
1002001
1002001
1002001
1002001
1002001
1002001
1002001
1002001
1002001
1002001
1002001
1002001
1002001
1002001
1002001
1002001
1002001
1002001
1002001
1002001
1002001
1002001
1002001
1002001
1002001
1002001
1002001
1002001
1002001
1002001
1002001
1002001
1002001
1002001
1002001
1002001
1002001
1002001
1002001
1002001
1002001
1002001
1002001
1002001
1002001
1002001
1002001
1002001
1002001
1002001
1002001
1002001
1002001
1002001
1002001
1002001
1002001
1002001
1002001
1002001
1002001
1002001
1002001
1002001
1002001
1002001
1002001
1002001
1002001
1002001
1002001
1002001
1002001
1002001
1002001
1002001
1002001
1002001
1002001
1002001
1002001
1002001
1002001
1002001
1002001
1002001
1002001
1002001
1002001
1002001
1002001
1002001
1002001
1002001
1002001
1002001
1002001
1002001
1002001
1002001
1002001
1002001
1002001
1002001
1002001
1002001
1002001
1002001
1002001
1002001
1002001
1002001
1002001
1002001
1002001
1002001
1002001
1002001
1002001
1002001
1002001
1002001
1002001
1002001
1002001
1002001
1002001
1002001
1002001
1002001
1002001
1002001
1002001
1002001
1002001
1002001
1002001
1002001
1002001
1002001
1002001
1002001
1002001
1002001
1002001
1002001
1002001
1002001
1002001
1002001
1002001
1002001
1002001
1002001
1002001
1002001
1002001
1002001
1002001
1002001
1002001
1002001
1002001
1002001
1002001
1002001
1002001
1002001
1002001
1002001
1002001
1002001
1002001
1002001
1002001
1002001
1002001
1002001
1002001
1002001
1002001
1002001
1002001
1002001
1002001
1002001
1002001
1002001
1002001
1002001
1002001
1002001
1002001
1002001
1002001
1002001
1002001
1002001
1002001
1002001
1002001
1002001
1002001
1002001
1002001
1002001
1002001
1002001
1002001
1002001
1002001
1002001
1002001
1002001
1002001
1002001
1002001
1002001
1002001
1002001
1002001
1002001
1002001
1002001
1002001
1002001
1002001
1002001
1002001
1002001
1002001
1002001
1002001
1002001
1002001
1002001
1002001
1002001
1002001
1002001
1002001
1002001
1002001
1002001
1002001
1002001
1002001
1002001
1002001
1002001
1002001
1002001
1002001
1002001
1002001
1002001
1002001
1002001
1002001
1002001
1002001
1002001
1002001
1002001
1002001
1002001
1002001
1002001
1002001
1002001
1002001
1002001
1002001
1002001
1002001
1002001
1002001
1002001
1002001
1002001
1002001
1002001
1002001
1002001
1002001
1002001
1002001
1002001
1002001
1002001
1002001
1002001
1002001
1002001
1002001
1002001
1002001
1002001
1002001
1002001
1002001
1002001
1002001
1002001
1002001
1002001
1002001
1002001
1002001
1002001
1002001
1002001
1002001
1002001
1002001
1002001
1002001
1002001
1002001
1002001
1002001
1002001
1002001
1002001
1002001
1002001
1002001
1002001
1002001
1002001
1002001
1002001
1002001
1002001
1002001
1002001
1002001
1002001
1002001
1002001
1002001
1002001
1002001
1002001
1002001
1002001
1002001
1002001
1002001
1002001
1002001
1002001
1002001
1002001
1002001
1002001
1002001
1002001
1002001
1002001
1002001
1002001
1002001
1002001
1002001
1002001
1002001
1002001
1002001
1002001
1002001
1002001
1002001
1002001
1002001
1002001
1002001
1002001
1002001
1002001
1002001
1002001
1002001
1002001
1002001
1002001
1002001
1002001
1002001
1002001
1002001
1002001
1002001
1002001
1002001
1002001
1002001
1002001
1002001
1002001
1002001
1002001
1002001
1002001
1002001
1002001
1002001
1002001
1002001
1002001
1002001
1002001
1002001
1002001
1002001
1002001
1002001
1002001
1002001
1002001
1002001
1002001
1002001
1002001
1002001
1002001
1002001
1002001
1002001
1002001
1002001
1002001
1002001
1002001
1002001
1002001
1002001
1002001
1002001
1002001
1002001
1002001
1002001
1002001
1002001
1002001
1002001
1002001
1002001
1002001
1002001
1002001
1002001
1002001
1002001
1002001
1002001
1002001
1002001
1002001
1002001
1002001
1002001
1002001
1002001
1002001
1002001
1002001
1002001
1002001
1002001
1002001
1002001
1002001
1002001
1002001
1002001
1002001
1002001
1002001
1002001
1002001
1002001
1002001
1002001
1002001
1002001
1002001
1002001
1002001
1002001
1002001
1002001
1002001
1002001
1002001
1002001
1002001
1002001
1002001
1002001
1002001
1002001
1002001
1002001
1002001
1002001
1002001
1002001
1002001
1002001
1002001
1002001
1002001
1002001
1002001
1002001
1002001
1002001
1002001
1002001
1002001
1002001
1002001
1002001
1002001
1002001
1002001
1002001
1002001
1002001
1002001
1002001
1002001
1002001
1002001
1002001
1002001
1002001
1002001
1002001
1002001
1002001
1002001
1002001
1002001
1002001
1002001
1002001
1002001
1002001
1002001
1002001
1002001
1002001
1002001
1002001
1002001
1002001
1002001
1002001
1002001
1002001
1002001
1002001
1002001
1002001
1002001
1002001
1002001
1002001
1002001
1002001
1002001
1002001
1002001
1002001
1002001
1002001
1002001
1002001
1002001
1002001
1002001
1002001
1002001
1002001
1002001
1002001
1002001
1002001
1002001
1002001
1002001
1002001
1002001
1002001
1002001
1002001
1002001
1002001
1002001
1002001
1002001
1002001
1002001
1002001
1002001
1002001
1002001
1002001
1002001
1002001
1002001
1002001
1002001
1002001
1002001
1002001
1002001
1002001
1002001
1002001
1002001
1002001
1002001
1002001
1002001
1002001
1002001
1002001
1002001
1002001
1002001
1002001
1002001
1002001
1002001
1002001
1002001
1002001
1002001
1002001
1002001
1002001
1002001
1002001
1002001
1002001
1002001
1002001
1002001
1002001
1002001
1002001
1002001
1002001
1002001
1002001
1002001
1002001
1002001
1002001
1002001
1002001
1002001
1002001
1002001
1002001
1002001
1002001
1002001
1002001
1002001
1002001
1002001
1002001
1002001
1002001
1002001
1002001
1002001
1002001
1002001
1002001
1002001
1002001
1002001
1002001
1002001
1002001
1002001
1002001
1002001
1002001
1002001
1002001
1002001
1002001
1002001
1002001
1002001
1002001
1002001
1002001
1002001
1002001
1002001
1002001
1002001
1002001
1002001
1002001
1002001
1002001
1002001
1002001
1002001
1002001
1002001
1002001
1002001
1002001
1002001
1002001
1002001
1002001
1002001
1002001
1002001
1002001
1002001
1002001
1002001
1002001
1002001
1002001
1002001
1002001
1002001
1002001
1002001
1002001
1002001
1002001
1002001
1002001
1002001
1002001
1002001
1002001
1002001
1002001
1002001
1002001
1002001
1002001
1002001
1002001
1002001
1002001
1002001
1002001
1002001
1002001
1002001
1002001
1002001
1002001
1002001
1002001
1002001
1002001
1002001
1002001
1002001
1002001
1002001
1002001
1002001
1002001
1002001
1002001
1002001
1002001
1002001
1002001
1002001
1002001
1002001
1002001
1002001
1002001
1002001
1002001
1002001
1002001
1002001
1002001
1002001
1002001
1002001
1002001
1002001
1002001
1002001
1002001
1002001
1002001
1002001
1002001
1002001
1002001
1002001
1002001
1002001
1002001
1002001
1002001
1002001
1002001
1002001
1002001
1002001
1002001
1002001
1002001
1002001
1002001
1002001
1002001
1002001
1002001
1002001
1002001
1002001
1002001
1002001
1002001
1002001
1002001
1002001
1002001
1002001
1002001
1002001
1002001
1002001
1002001
1002001
1002001
1002001
1002001
1002001
1002001
1002001
1002001
1002001
1002001
1002001
1002001
1002001
1002001
1002001
1002001
1002001
1002001
1002001
1002001
1002001
1002001
1002001
1002001
1002001
1002001
1002001
1002001
1002001
1002001
1002001
1002001
1002001
1002001
1002001
1002001
1002001
1002001
1002001
1002001
1002001
1002001
1002001
1002001
1002001
1002001
1002001
1002001
1002001
1002001
1002001
1002001
1002001
1002001
1002001
1002001
1002001
1002001
1002001
1002001
1002001
1002001
1002001
1002001
1002001
1002001
1002001
1002001
1002001
1002001
1002001
1002001
1002001
1002001
1002001
1002001
1002001
1002001
1002001
1002001
1002001
1002001
1002001
1002001
1002001
1002001
1002001
1002001
1002001
1002001
1002001
1002001
1002001
1002001
1002001
1002001
1002001
1002001
1002001
1002001
1002001
1002001
1002001
1002001
1002001
1002001
1002001
1002001
1002001
1002001
1002001
1002001
1002001
1002001
1002001
1002001
1002001
1002001
1002001
1002001
1002001
1002001
1002001
1002001
1002001
1002001
1002001
1002001
1002001
1002001
1002001
1002001
1002001
1002001
1002001
1002001
1002001
1002001
1002001
1002001
1002001
1002001
1002001
1002001
1002001
1002001
1002001
1002001
1002001
1002001
1002001
1002001
1002001
1002001
1002001
1002001
1002001
1002001
1002001
1002001
1002001
1002001
1002001
1002001
1002001
1002001
1002001
1002001
1002001
1002001
1002001
1002001
1002001
1002001
1002001
1002001
1002001
1002001
1002001
1002001
1002001
1002001
1002001
1002001
1002001
1002001
1002001
1002001
1002001
1002001
1002001
1002001
1002001
1002001
1002001
1002001
1002001
1002001
1002001
1002001
1002001
1002001
1002001
1111111